111111111111111111111111111111
100000000000001100000000000001
1P0000000000001100000000000001
1000N00000000C1100000000000001
100000000E000C1100000000000001
1000000000000C1100000000000001
100000000000000000000000000001
100000000000000000000000000001
100000000000000000000000000001
100000000000000000000000000001
100000000000000000000000000001
100000000000000000000000000001
100000000000000000000000000001
100000000000000000000000000001
100000000000000000000000000001
100000000000000000000000000001
111111111111111111111111111111