111111111111111
100000000000001
1P0000000000001
100100000000001
100100000E00011
100000000000001
100000000000001
111111111111111