111111111111111
100000000000001
1P0000000000001
1000N00000000C1
111111111111111
100000000E000C1
1000000000000C1
111111111111111