111111111111111
100000000000001
100000000000001
1001000000000C1
100100000E000C1
1000000000000C1
1000000000000C1
111111111111111